Developers Past and Present
---------------------------
- Ted Kulp <wishy [AT] cmsmadesimple [DOT] org>
- Robert Campbell <calguy1000 [AT] cmsmadesimple [DOT] org>
- Morten Poulsen <morten [AT] poulsen [DOT] org>
- Nuno Costa <nuno [AT] criacaoweb [DOT] net>
- Alberto Benati <alberto [DOT] benati [AT] gmail [DOT] com>
- Samuel Goldstein <cmsmadesimple [AT] fogbound [DOT] net>
- Tatu Wikman <tsw [AT] cmsmadesimple [DOT] org>

- Alexander Endresen <alexander [AT] endresen [DOT] org>
- Patricia Brun <cmsms [AT] virtuaza [DOT] net>
- Daniel Westergren <daniel [AT] wproductions [DOT] se>
- Greg Froese <heavy_g [AT] users.sf [DOT] net>
- Rob Allen <rob [AT] akrabat [DOT] com>
- Simon Brown <simon [AT] uptoeleven [DOT] ws>
- Sorin Sbarnea <sorin [AT] intersol [DOT] ro>
- Brett Batie <brett-cms [AT] classicwebdevelopment [DOT] com>
- Thijs Elenbaas <thijs [AT] contemplated [DOT] net>
- Julien Lancien <calexico [AT] cmsmadesimple [DOT] org>
- Christian Page <christian [AT] localdesert [DOT] com>
- Darren Landrum <consul [AT] studioconsul [DOT] net>

 
Translators
-----------
The following people have contributed translations to CMS Made Simple since March of 2009.   
If we have missed anybody please contact us and we will add your name for future releases.

- Jacek Brzeski -- jacek [AT] numer9 [DOT] pl
- Miloš Kroulík -- milos.kroulik [AT] email [DOT] cz
- Panagiotis Skarvelis -- sl45sms [AT] yahoo [DOT] gr
- Petr Jelínek -- peca.cz [AT] gmail [DOT] com
- Jean-Claude Etiemble -- jc.etiemble [AT] free [DOT] fr
- Daniel Vives -- daniel.vives [AT] catalonia [DOT] net
- Christian Peretto -- christian [AT] lineapixel [DOT] com
- Daniel Navarro -- danipelon [AT] gmail [DOT] com
- Ronald Timmers -- webmaster [AT] id2020 [DOT] nl
- Mirko Barbulović -- barbonister [AT] gmail [DOT] com
- Zdeno Kuzmany -- zdeno [AT] kuzmany [DOT] biz
- Bálint Kozman -- qzy [AT] ultramarin [DOT] hu
- Sergey Mastykov -- sergey.mastykov [AT] gmail [DOT] com
- Cornel Dan -- dan_4jc [AT] yahoo [DOT] com
- Paco Orozco -- pakusland [AT] gmail [DOT] com
- Patricia Brun Torre -- cmsms [AT] virtuaza [DOT] org
- Takayuki Kobayashi -- koba [AT] zuifu [DOT] com
- clementina immirzi -- clementinai [AT] yahoo [DOT] com
- Ronny Krijt -- r.krijt [AT] gmail [DOT] com
- Ilya  -- ilia3d [AT] web [DOT] de
- Birger Eriksson -- birger [AT] pckart [DOT] se
- Piotras Cimmperman -- vilkis [AT] gmail [DOT] com
- Vedat Karaduman -- vedatkaraduman [AT] gmail [DOT] com
- Sofia Hauschildt -- sofia [AT] hauschildt [DOT] net
- Michael Kenis -- michael [AT] k-id [DOT] nl
- Franck Lafay -- franck.lafay [AT] orange [DOT] fr
- Joost de Bruijn -- joostdebruijn [AT] planet [DOT] nl
- Morten Poulsen -- morten [AT] poulsen [DOT] org
- Gour D. -- gour [AT] atmarama [DOT] net
- Jonas Rydén -- cold.man [AT] live [DOT] se
- Sinus Iks -- jaka99 [AT] gmail [DOT] com
- Gion-Andri Cantieni -- gion-andri [AT] gmx [DOT] ch
- Alberto Benati -- cms [AT] xme [DOT] it
- Robert Campbell -- calguy1000 [AT] cmsmadesimple [DOT] org
- Nuno Costa -- nuno.mfcosta [AT] sapo [DOT] pt
- Eduardo Martinez -- edmartgt [AT] yahoo [DOT] com
- Square -- benjamin_cantele [AT] yahoo [DOT] fr
- Andreas Just -- wilfried44g [AT] googlemail [DOT] com
- René Helminsen -- cmsms [AT] helminsen [DOT] no
- Anne-Mieke Bovelett -- anne [AT] cmsmadesimple [DOT] org
- Stephan -- vipstephan [AT] gmail [DOT] com
- Kaupo Vana -- kaupov3 [AT] hot [DOT] ee
- Christoffer L -- christoffer.la [AT] hotmail [DOT] com
- Christophe Lherieau -- skimpax [AT] gmail [DOT] com
- Rolf -- rolf [AT] cmsmadesimple [DOT] org
- Anton Evseichev -- jn0izzze [AT] gmail [DOT] com
- Oskar Rough -- oskar [AT] lyf [DOT] dk
- RichardD -- richard [DOT] desiatnik [AT] ume [DOT] se
- Hendrie Bosch -- boschie [AT] tegramsbergen [DOT] nl
- Tapio Löytty -- tapsa [AT] blackmilk [DOT] fi
- yulik -- 4x6hp [AT] 4x6hp [DOT] net
- Cosmin Hutanu -- urecheatu007 [AT] gmail [DOT] com
- Omid Ahn -- omidahn [AT] gmail [DOT] com
- Heikki Ylipaavalniemi -- heikki [DOT] y [AT] empiria [DOT] org
- Zelimir Mikulic -- zelimir [DOT] mikulic [AT] vus [DOT] hr
- Andrew Minton -- moonoo [DOT] am [AT] gmail [DOT] com
- Jonathan Schmid -- hi [AT] jonathanschmid [DOT] de
- Lukasz Bigoszewski -- bigoszewski [AT] excel [DOT] pl
- Goran Ilic -- g [DOT] ilic [AT] i-arts [DOT] eu
- Benoit Vermont -- redwarp [AT] gmail [DOT] com
- Aire Libre (Mathieu M [DOT] ) -- contact [AT] airelibre [DOT] fr
- Farhad Pezeshki -- farhadrm [AT] hotmail [DOT] com
- Alex -- html5sf [AT] gmail [DOT] com

Past Translators
-----------------
Brazilian Portugese: Jose Diogenes Silva <josediogenes [AT] gmail [DOT] com>

Bulgarian:  Jd Hlebarov <dichka [AT] gmail [DOT] com>

Chinese (simplified): liuyi yi liu <liuyisc [AT] gmail [DOT] com>

Czech: Petr Jelinek <pjelinek [AT] seznam [DOT] cz>

Danish: Morten Poulsen <morten [AT] poulsen [DOT] org>

Dutch: Sjaak <sjaak [AT] nlweb [DOT] net>
       Jesca Z <jesca [AT] zweijtzer [DOT] nl>
       Ronny Krijt <ronnyk [AT] cmsmadesimple [DOT] org>
	   Rolf <rolf [at] cmsmadesimple [dot] org>

French: Herve Commowick <daycom [AT] daycom [DOT] net>,
        Patricia Brun <cmsms [AT] virtuaza [DOT] net>

Finnish: Jani Mikkonen <jani [AT] mikkonen [DOT] org>,
        Tatu Wikman <tsw [AT] lemtek [DOT] fi>,
        Teemu Koistinen <japsifoorumi [AT] kapsi [DOT] fi>

German: Jan Czarnowski <czarnowski [AT] coftware [DOT] de>
        Andreas Just <andreas_just [AT] web [DOT] de>
		
Greek: Panagiotis Skarvelis <sl45sms [AT] yahoo [DOT] gr>

Italian: Alberto Benati <benati [AT] economia.unife [DOT] it>

Japanese: Victor Alexander Debuque <victor [AT] nuspace.net [DOT] au>

Lituanian: Tomas Paplauskas <tmzsegardc [AT] accessatc [DOT] net>

Norwegian: Rene Helminsen <renehelminsen [AT] gmail [DOT] com>,
           Jon A Holm <jaholm [AT] start [DOT] no>,
           Alexander Endresen <alexander [AT] endresen [DOT] org>,
           Bjorn Are Solstad <basicus [AT] gmail [DOT] com>

Polish: Piotr Tarnowski <drfugazi [AT] drfugazi.eu [DOT] org>

Portuguese: Nuno Costa <nuno [AT] criacaoweb [DOT] net>

Russian: Tyaga Alex Pool <webmaste [AT] superhonda [DOT] ru>

Slovak: Roman Hanajik <roman.hanajik [AT] centrum [DOT] cz>

Spanish: Carlos Urbieta <carlos [AT] urbieta [DOT] com>,
        Roberto del Pino <fexcel [AT] terra [DOT] es>

Swedish: Tobias Amnell <tobias.amnell [AT] home [DOT] se>,
         Daniel Westergren <daniel [AT] wproductions [DOT] se>

Contributors
------------
Leendert Meyer: Horizontal menu patch and svn cleanup scripts
